   ########^##########
   #                 #
   #                 #
   #                 #
   #                 #
####                 #########
<|                   ]       >
####                 #########
   #                 #
   #                 #
   #                 #
   #%                #
   #v###########^#####